..X..........X..
................
.....X....XX....
...X..X..X..X...
..X...X..X...X..
.......XX.......
.X..............
....XX.XX.XX....
...X........X...
X......X.......X
........X.......
...X.....X..X...
........X.......
................
.......XXX......
................